000000000000000000000000
000000111100012033000000
000011100000002223340000
001100000000001122344400
021000000000000012303440
010000000000000010223330
010000010000000000122020
010000100000100000001110
010000000000000000000000
010000100000001000000000
010000110000000000000000
010000001100000100000010
011000000000001000001010
021000000000001000010220
022100000000000000010330
002211110000000000112300
000022210000000000120000
000000222110000001000000
000000000000000000000000
