000000000000000000000000
000050000000001200000000
005400100000001234500600
000032100000001234555050
000432000000111004444400
005032100001120000333300
005430100001120000222200
005432100000111001111110
005430110000000011000000
000432010000000000000000
090033210000000000000000
000003221111100000000000
008700322200111111000080
000060033302002220000700
000005444430033333456000
000065505044404444400000
000766660555555550000900
000000776666000006090000
000000000000000000000000
