000000000000000000000000
000000000000000000000000
000000000000000000000000
000000000000000000000000
000000000000000000000000
000000008705432100000000
000000008765432100000000
000000007765432100000000
000000006665432110000000
000000005505432220000000
000000004444433330000000
000000004333333340000000
000000004322222340000000
000000004321110030000000
000000004020001230000000
000000000000000000000000
000000000000000000000000
000000000000000000000000
000000000000000000000000
