000000000000000000000000
000000000000000000000000
000000000000000000000000
000000000000000000000000
000000000000000000000000
000044444444444444400000
000044000000000004400000
0000444444XXX44444400000
0000444444X0X44444400000
0000444444XXX44444400000
000044444444444444400000
000044444444444444400000
000044444444444444400000
000044444442444444400000
000000000000000000000000
000000000000000000000000
000000000000000000000000
000000000000000000000000
000000000000000000000000
