000000000000000000000000
000000002100000000000000
000000430100001200000000
000065432100001234000000
000765030000001034500000
000706032010000230560000
090000032100001034560000
000000030100001234000000
099000320000001004567000
000000321100010234060000
040000320000012030567000
003000320000012344560000
022000221000012345000000
001000110000012300000000
000000000000122340600000
001000000000020045000000
000000000000100500000000
000000000000100000000000
000000000000000000000000
