000000000000000000000000
000000000000000000000000
000000000000000000000000
000000000000000000000000
000000000000000000000000
000000000123456780000000
000000000123456780000000
000000000123456770000000
000000001123456660000000
000000002023450560000000
000000003333444560000000
000000004433330000000000
000000004302222230000000
000000004321111230000000
000000004320001230000000
000000000000000000000000
000000000000000000000000
000000000000000000000000
000000000000000000000000
