000000000000000000000000
000000000456000000099999
000000123400006789999900
000000120004456789990000
000000000003456789900000
000000100223456789000000
000000101123456780000000
000000000123456780000000
000000000123456789000000
000000000123456789000000
000000101123456789000000
000000202223456780000000
000000303333456780000000
000000204444456780000000
000000100555556780000000
000000020666666780000000
000000030777777700000000
000000040088888800000000
000000000099999900000000
