000000000000000000000000
000000001000103400000000
000000211000023000000330
000003200000120000002200
000033010000120000011110
000032010000100000100000
000222100001100000000000
000120100000220000000000
000011000001221000000010
000000000011211000001100
000000000000200000012200
000000000000010000012000
011000000000210000022000
000101000002100001120000
002220000020100000220000
003000000211000001200000
000000003200000012000000
000000543010000000000000
000000000000000000000000
