000000000000000000000000
000000002010000030000000
000765432100001234070000
000000430100001030066700
000055002000000034556000
000654021100001230400500
000004301000010233030400
000554321000011222233300
000040021000001111200200
000043210000000001111110
000500210000000000000000
000543010000000000000000
000003200000100000000000
000000210000100100000000
000543200000122001110000
000040200000103322000900
000003210000104300090000
000000010000000009009900
000000000000000000000000
