909007000500200020000000
099987654403210111111000
099887054330010000000000
998877654022100000000000
008776054001100000000010
088766540321000000000010
077705003000000010100000
606604022000000000100010
555004321000000100100000
044033001000000100000010
543332221000000001000010
000222100000001001000000
011110100000000001000100
000000000000000000000100
000000000000000010000100
000000000000000000000000
110000000000000000001000
222100000000100000000000
000000000002100000000000
