000000000000000000000000
000000554321000002000000
000076540001000010090900
008876543010000002090000
098700543200000100000000
098065503210000100000000
099000400210000000000000
099900032100000090000090
099000400100000090000000
099005002100000000000090
098060432000000090000090
098765432000000000000090
098065000100000090000000
098700032000000000000090
098880400100000000000000
009870032010000000000120
000076003200000000000020
000000543010000000000000
000000000000000000000000
