000000000000000000000000
000000000000000000000000
000000000000000000111000
000000000001111111000000
000001110000000000000000
000010000000000000000000
000000000000000000000000
000000000001000000000110
000000001121001000102200
000000010000220040223330
000001002043333443030000
000000122330404404440670
000000012023330055055600
000000000120223455066000
000000000000103045670780
000000000000000340678800
000100000000002000070990
000001000000012345678000
000000000000000000000000
