000000000000000000000000
000000000000000000000000
000000003210000120000000
000000432200000023450000
000004432110000123000000
000044300100000020006000
000333022100000123056000
002222221000001223450000
001110010000001230000000
000000000000002203030000
000000000000011202200000
000000000000001011230000
001000000000000001034000
000110111000000000000000
000022200110000000010000
000003332011000000000000
000000003220211000012000
000000000003220000010000
000000000000000000000000
