000000000000000000000000
000000032100012000060090
090050330100012340500900
000604320000010344400090
007000301000012330333000
080890301000012302020200
009000321000010221111000
009050320000001101000000
009004301000000000000000
090000321100000000000000
000600300100000000000000
000650320000000000001010
007604301000001011111020
080004301000001202022200
009900321000010233330030
009004301000001200444040
090050321100001234505500
009004002100001230060660
000000000000000000000000
