000000000000000000000000
000000010000203450000000
000543210001123044400000
000040000000103430333000
006503010000023002020200
000543210000022222111100
000003010000120110000000
000543210000001000000000
000043010000000000000000
000000210000000000000000
000032100000000000001100
000032000000000101022000
000002100000001222233000
005032000000222203330000
005402100001220034444000
000432000000012344050090
000003200000010300060000
000000010000010009000990
000000000000000000000000
