000000000000009999000000
000000000002008888000000
000021000010077770000000
000210000010666600000000
000010000020555500000000
000010000100444400000000
043000000103333400000000
003210000002223400000000
043010000011123400000000
003200000000123450000000
000001000000123450000000
000210000000123450000000
003200000011123450000000
000210000022223400000000
000100000033333400000000
000000000004444450000000
000100001005555550000000
000000001006666660000000
000000000007777770000000
