000000000000000000000000
000004003020000010045600
000004332021000012340600
000033020111000000345000
000022201000000000045000
000011121000000112345600
000000121000000120345670
000000111000111100445670
000000000000122223400670
021000000000123333345670
000000000000100222345660
000000000001001012345500
001111110000000000044500
002200210000000000034000
000000010000000001234000
000003210000000001230000
000003210000000001234000
000000010000011100004500
000000000000000000000000
