000000000000000000000000
088800000000000000008880
077777777700000777777770
066666666666666666666660
050555555555505055555500
040444444444555404444040
003330333334444433303030
030202002233303332002220
022111111022222220111100
011000001111011111000000
000000000001000000000000
000000000000000000000000
000000000000000000000000
001100100000000001101100
000222100000110012222000
000032000000000122300000
000002100000000103340000
000000000000000123000000
000000000000000000000000
