000000000000000000000000
000000900000000009000000
000999909090090909999000
009999900000000009999900
009000000000000000000900
099000000000000000000990
099000000000000000000990
088088800000000008880880
077087700000000007780770
066087600000000006780660
055087654322223456780550
044000000001100000000440
033000000000000000000330
022000000000000000000220
001111112100001211111100
000000011100001110000000
000000000000000000000000
000000000000000000000000
000000000000000000000000
