000000000000000000000000
070000000000000000000040
066600000000000000003330
055555500000000002222220
044044444440032221100110
033300344333222110000000
022202304322211000000000
011012040321000000000000
000012340220000000000010
000012343210000000110120
000010043210000011002220
000012330200000022233330
000000222110000123304440
000000100100001100440550
000000000100001223400660
000000000000001030456700
000000000000000044550000
000011000000012345000000
000000000000000000000000
