000000000000000000000000
000050300100000007780990
044444321000010306080090
030330301000002305090990
020202200000002344099900
011100110000112033000000
000000000000120322202000
000000000000122221101110
000000000000012100000000
010000000000001000000000
000010011000000000000000
050022201000000000000000
004330300100000000011010
054000320000000000012220
005090201000000011120300
006080010000001122003400
077780010000112003304400
008089000000002304440500
000000000000000000000000
