000000000000000000000000
000000000000211000000000
000500000211100000010000
004440002100000000010000
033300022100000000112000
022220011000000010022000
001100100000001012333300
000000000000000112304400
000000000000000002345500
000000000000000012305660
000000010000000012040670
001111012301000012345600
000202220321000002305600
000333303201000010345600
000040432010000122305000
000005432110000020340000
000000430100000123000000
000000002100001100000000
000000000000000000000000
