909999909009009099900990
009090099099999999990990
990999999999999009999999
909999909900999909999090
808888888888888088888880
877707077770777777007778
006666666666666666666600
505550555555005555555676
044440444444444440445060
043333333333433033345005
433222222220002222305665
032211110111111112200000
222110000000000011000110
211100000000000000010000
110000000000000000000000
000000000000000000000000
000000011000001100000000
000001100100001111001110
110000022100011220002211
