000000000000000000000000
000000000000000000000000
000000000000000000000000
000000000000000000000100
000000000000000000000000
000000000000000000001000
004400000000000000001000
003300000000045432111200
002220000000300402002000
011010000000234033333000
000011010001234330333400
000000110001034320020000
000000010000200021101100
000000000000111100000000
000000000000000000000000
000100000000000000000000
000001010000000000000000
000000000100000000000000
000000000000000000000000
