000000000022345600000000
000000000012345000000000
000000000012345000000000
000000000012345000000000
000000000012344000000000
000000000112334000000000
000000000022234500000000
010000000011234500000000
000000000001234500000000
010000000001234500000000
010000000001234500000000
000000010011234500000000
001000000222234500000000
001000000333334000000000
000000000044444000000000
000100000055555000000000
000000000055555600000000
000000000004445600000000
000000000003345600000000
