000000000000000000000000
099000210001220000900000
000043210000120450000900
000543200000123456660000
005043010000103450555000
004433010000100440044500
043302210000120344330500
000200110000122334020000
001110000000012200021100
021000000000001111110000
010000000000000000000000
010000000000000000000000
000000100100000000000000
000001120210100000000000
000000223022110000112300
000000033330020000000000
000100000000033000000900
000009000000000400099000
000000000000000000000000
