000000000000000000000000
000909090000000000000000
000000000000000000000000
000000000000000000000000
000000000000000000000000
000000000000000000000000
880000000000000000000000
777000000444000000000000
606000004433000333330000
055000003002222220233333
404000003200111001202222
433000002211000001111001
032000001000000000000000
432100000000000000000000
432100000000000000000000
030100000000000001000000
032100000011100001111101
032111000102100001200020
430002232222100011234000
