000000000000000000000000
000000009999999999990000
000990099999000099900009
000088888800009999000009
099987777700899900000080
999987666667890000000078
000000655560000000000600
000000004000000000005555
000000003000000000344440
000000002000000222334033
222220001001111110203322
111111100010000011120021
000010000000000000012221
000000000000000000011120
000000000000000000000011
000000001000011000000000
111110011000010100000000
222000221000012111100000
333343321100012222110001
