000000000022234500000000
000000000011234500000000
000000000001234500000000
000000000001234500000000
000000000001234000000000
000000011011234000000000
000000120022234000000000
000001200333330000000000
000001004444400000000000
200000034555000000000000
210001234560000000000000
211111234500000000000000
022222234000000000000000
000000000000000000000000
000000000000000000000000
000000000000000000000000
000000000000000000000000
000000000000000000000000
000000000000000000000000
