000000000000000000000000
000000000000000000000000
000000000000000000000000
000000000000000000000000
000000004320001230000000
000000004321111230000000
000000004320222230000000
000000004330333300000000
000000004444444440000000
000000005555555500000000
000000004404444440000000
000000003333333330000000
000000003222222230000000
000000000210111230000000
000000003210000030000000
000000000000000000000000
000000000000000000000000
000000000000000000000000
000000000000000000000000
