000000000000000000000000
000000000000000000000000
000000000000000000000000
000000000000000000000000
000000003200001230000000
000000003211111230000000
000000003220222230000000
000000000023333330000000
000000001123444440000000
000000000123405550000000
000000000103456660000000
000000000123456070000000
000000000120456700000000
000000002223456700000000
000000003333056780000000
000000000000000000000000
000000000000000000000000
000000000000000000000000
000000000000000000000000
