000000000000000000000000
000000000000000000000000
000000000000000000000000
000000000000000000000000
000000003200001230000000
000000003211111200000000
000000003222222230000000
000000003333333330000000
000000004444044440000000
000000005555500550000000
000000005444404440000000
000000005033333330000000
000000000022202200000000
000000003201111230000000
000000003210001030000000
000000000000000000000000
000000000000000000000000
000000000000000000000000
000000000000000000000000
