000000000000000000000000
000000000000000000000000
000000000000000000000000
000000000000000000000000
000000008765555550000000
000000008765444040000000
000000008765433030000000
000000007765402200000000
000000000665432110000000
000000005555432100000000
000000004444432100000000
000000000303332100000000
000000003322222110000000
000000003201111220000000
000000003210001230000000
000000000000000000000000
000000000000000000000000
000000000000000000000000
000000000000000000000000
