000000000000000000000000
000000432100011234000000
000033302100000234450000
002222002100001033456700
011110000100000020456780
000000000010000103006780
000000000000000004400780
000000000000000105008880
011000000000000004088890
021101000000011034007890
022220110011112234567890
033330022220022034067890
044444303300003344507890
055504444000000405507890
066650555000000556667890
007666666600006666077800
000077707770077007780000
000000888088888888000000
000000000000000000000000
