000000000000000000000000
000000000000000000000000
000000000000000000000000
000000000000000000000000
000000111000000000000000
000000000000000000000000
000000000000000000000000
000000000110010000000000
000000010100000000000010
000000012111111011111010
000000012222222222222210
000000012333333333333211
011101112344444444443220
022002222300000555540000
033033333000000000000000
444044440000000000000000
550055550000000000000000
660666600000000000000000
770777000000000000000000
