000000000000000000000000
000009000044040000009000
009000033333303340000900
000002222200222003300000
032221011111112022202220
000110000000001111011110
011000000000000000000000
000000000000000000000000
000000000000000000000000
000000000000000000000110
000011000000000011111200
000112000000011000202230
032202000001112203033000
003300000000000000444450
044000000000000000005050
005000000000000000006600
000000000000000000000000
000000000000000000000000
000000000000000000000000
