000000000000000000000000
000004003000011230067700
000004332000000034560600
000003020100001000555000
000002201000001200044000
000001121000001222333300
000000121000001110222220
000000111000000000111110
000000000000000000000000
021000000000000000000000
000000000000100000000000
000000000001001011111100
001111110000000000022200
002200210000000000033000
000000010000000001234000
000003210000000001230000
000003210000000001234000
000000010000011100004500
000000000000000000000000
