000000000000000000000000
000000000021000000000000
000000034321000012000000
000222233301000002340000
001111022021000012033300
000000110021000002320220
000000000110000012201010
000000000000000001000000
010000000000000000000000
021111000000000000000000
002202110000000000000010
003332021100000000000100
000433322010000011012200
000440002110000122222000
000050432000000100333000
000005400100001223440000
000000432100001233000000
000000002100012000000000
000000000000000000000000
