000000000009999990000000
000010000200999990000000
000100001200999990000000
000100001200999990000000
002100000208888800000000
002000000207777700000000
002100001206666600000000
032100001200555550000000
032100000020444450000000
032010000120333450000000
033010000100223450000000
044000000000123456000000
054301000000123456000000
004321000000123456000000
004320000000123456000000
000320000010023450000000
000021000010033450000000
000000100000044456000000
000000000000005556000000
