000000000000000000000000
000000000100001200009900
000002221100000234500090
000221010000001034066000
000010000000011034550600
000000000000002234045000
000000000001000303300600
000000000011232202220000
000000000001222111111010
001100000000111000000000
020210000000000000000000
003201100000000000000000
003022101000000000000000
040032200000000001001100
005003010000000111222020
000043210000101202233000
090003200000022233030400
000900210000120004404000
000000000000000000000000
