000000000000000000000000
000000000000000000000000
000000000000000000000000
000000000000000000000000
000000003210001230000000
000000000211111230000000
000000003222222230000000
000000003333033330000000
000000004404444440000000
000000005555555550000000
000000004044444440000000
000000003303333340000000
000000003222022300000000
000000003211112040000000
000000003210002340000000
000000000000000000000000
000000000000000000000000
000000000000000000000000
000000000000000000000000
